                     NO     ./textures/bluestone.xpm
       SO                                  ./textures/colorstone.xpm
  WE            ./textures/greystone.xpm
EA     ./textures/purplestone.xpm

   F      80,80,80
C                 0,150,180

      1111111111111111
    11100001000001
111110001101011101
    1011000W111001111
  1110100001111000001
    10001101100001011
    1111000110110001
       1000000111101      
   11111010110000001111111
       1000000111011  
       111111111111111